• Список препаратов

• Головная боль (спрашиваем как сильно болит голова)

- Обычная: Пенталгин, Спазган, Миг, Некст, Дексалгин
- Сильная (мигрень): Амигрен, Сумамигрен
- Судороги, нервный тик: Магнелис, Аспаркам

• Боль в животе (спрашиваем вид боли)

- Тошнота: Церукал, Драмина
- Спазмы: Нош-па, Дротаверин
- Диарея: Лоперамид, Лопедиум (при сильном отравлении необходимо провести промывание желудка)
- Отравление: Энтеродез, Энтеросгель, Смекта

• Изжога: Ренни, Маалокс, Мотилиум

• Боль в печени: Карсил Форте, Гепабене

• Боль в сердце: Кардиомагнил

• Простуда и жар: Терафлю, Колдрекс, Антигриппин

• Кашель: Лазолван, Стоптуссин Пертуссин                      

• Боль в горле

- Спреи: Гексорал, Стопангин, Тантум верде
- Таблетки для рассасывания: Стрепсилс, Граммидин

• Насморк: Тизин, Снуп, Отривин

• Боль в спине, ногах и суставах: Фастум-гель, Кетонал, Долгит, Капсикам, Финалгон

• Мази от ушибов и ссадин: Долобене, Лиотон, Троксевазин, Фенистил, Кетонал

• Повышенное давление: Андипал

• Пониженное давление: Норадреналин, Кофеин (таблетки под язык), Кордиамин

• Аллергия: Дезал Зиртек Эриус, Зодак, Тавегил

• Ожоги: спрей Пантенол на ожог

• Глазная боль: Визин, Альбуцид

• Боль в ушах: Отипакс

• Боль в почках: Уролесан, Пролит

• Боль в мочевом пузыре: Цистон, Фитолизин

• Сотрясение: вместе назначить Диакарб и Пирацетам (то есть сосудистое + мочегонное для снятия отека мозга)

• Витамины: Компливит, Витрум     
                                            
• При сахарном диабете: Виктоза, Диабетон, Астрозон